,player,nationality,position,team,age,birth_year,minutes_90s,tackles,tackles_won,tackles_def_3rd,tackles_mid_3rd,tackles_att_3rd,challenge_tackles,challenges,challenge_tackles_pct,challenges_lost,blocks,blocked_shots,blocked_passes,interceptions,tackles_interceptions,clearances,errors,matches
0,Max Aarons,eng,DF,Bournemouth,23,2000,13.7,29,19,20,7,2,20,34,58.8,14,9,5,4,8,37,27,0,Matches
1,Joshua Acheampong,eng,DF,Chelsea,17,2006,0.1,0,0,0,0,0,0,0,,0,3,3,0,0,0,0,0,Matches
2,Tyler Adams,us,MF,Bournemouth,24,1999,1.3,4,3,1,3,0,2,3,66.7,1,2,0,2,4,8,2,0,Matches
3,Tosin Adarabioyo,eng,DF,Fulham,25,1997,18.0,21,11,16,5,0,12,21,57.1,9,16,11,5,25,46,80,0,Matches
4,Elijah Adebayo,eng,FW,Luton Town,25,1998,15.8,4,1,1,0,3,1,12,8.3,11,13,2,11,6,10,25,0,Matches
5,Simon Adingra,ci,FW,Brighton,21,2002,24.7,45,20,23,11,11,19,42,45.2,23,31,1,30,19,64,22,0,Matches
6,Nayef Aguerd,ma,DF,West Ham,27,1996,20.6,26,14,19,7,0,16,22,72.7,6,33,24,9,17,43,85,2,Matches
7,Brandon Aguilera,cr,FW,Nott'ham Forest,20,2003,0.1,0,0,0,0,0,0,0,,0,0,0,0,0,0,0,0,Matches
8,Naouirou Ahamada,fr,"MF,FW",Crystal Palace,21,2002,3.9,13,9,5,6,2,8,17,47.1,9,3,0,3,2,15,4,0,Matches
9,Anel Ahmedhodžić,ba,DF,Sheffield Utd,24,1999,29.4,64,36,48,14,2,30,49,61.2,19,43,26,17,35,99,137,2,Matches
10,Ola Aina,ng,DF,Nott'ham Forest,26,1996,18.8,47,31,31,12,4,29,41,70.7,12,19,3,16,18,65,51,1,Matches
11,Rayan Aït-Nouri,dz,"DF,MF",Wolves,22,2001,25.9,71,44,41,23,7,28,49,57.1,21,32,6,26,15,86,38,0,Matches
12,Kristoffer Ajer,no,DF,Brentford,25,1998,20.4,38,21,25,9,4,23,36,63.9,13,26,11,15,25,63,79,1,Matches
13,Manuel Akanji,ch,"DF,MF",Manchester City,28,1995,27.9,42,28,16,18,8,22,39,56.4,17,28,12,16,23,65,70,3,Matches
14,Nathan Aké,nl,DF,Manchester City,28,1995,22.7,26,16,15,8,3,13,20,65.0,7,17,2,15,14,40,54,0,Matches
15,Thiago Alcántara,es,MF,Liverpool,32,1991,0.1,0,0,0,0,0,0,0,,0,0,0,0,0,0,0,0,Matches
16,Trent Alexander-Arnold,eng,DF,Liverpool,24,1998,23.9,39,26,26,11,2,27,87,31.0,60,22,2,20,31,70,48,5,Matches
17,Alisson,br,GK,Liverpool,30,1992,28.0,0,0,0,0,0,0,1,0.0,1,0,0,0,0,0,11,4,Matches
18,Miguel Almirón,py,FW,Newcastle Utd,29,1994,21.5,36,24,13,15,8,11,29,37.9,18,29,2,27,10,46,13,0,Matches
19,Edson Álvarez,mx,MF,West Ham,25,1997,26.4,80,39,47,26,7,31,66,47.0,35,59,20,39,42,122,81,0,Matches
20,Julián Álvarez,ar,"MF,FW",Manchester City,23,2000,29.4,24,13,5,8,11,8,32,25.0,24,30,0,30,2,26,14,1,Matches
21,Zeki Amdouni,ch,FW,Burnley,22,2000,21.7,27,18,1,15,11,7,25,28.0,18,23,10,13,9,36,10,0,Matches
22,Sofyan Amrabat,ma,"MF,DF",Manchester Utd,26,1996,10.4,27,16,17,8,2,17,31,54.8,14,20,7,13,8,35,19,2,Matches
23,Joachim Andersen,dk,DF,Crystal Palace,27,1996,37.9,56,35,33,21,2,29,39,74.4,10,33,18,15,41,97,207,1,Matches
24,Elliot Anderson,eng,"MF,FW",Newcastle Utd,20,2002,11.4,24,18,12,9,3,15,29,51.7,14,23,4,19,8,32,23,0,Matches
25,Jaidon Anthony,eng,FW,Bournemouth,23,1999,1.7,3,1,1,0,2,1,7,14.3,6,3,0,3,1,4,3,0,Matches
26,Michail Antonio,jm,FW,West Ham,33,1990,18.8,15,8,5,6,4,3,11,27.3,8,16,3,13,4,19,4,0,Matches
27,Antony,br,FW,Manchester Utd,23,2000,14.7,40,21,15,19,6,20,40,50.0,20,29,1,28,12,52,9,0,Matches
28,Oliver Arblaster,eng,MF,Sheffield Utd,19,2004,10.5,23,14,11,8,4,7,15,46.7,8,17,7,10,15,38,9,0,Matches
29,Cameron Archer,eng,"FW,MF",Sheffield Utd,22,2001,20.4,18,13,6,6,6,8,18,44.4,10,22,3,19,1,19,11,0,Matches
30,Cameron Archer,eng,MF,Aston Villa,22,2001,0.1,0,0,0,0,0,0,0,,0,0,0,0,0,0,0,0,Matches
31,Alphonse Areola,fr,GK,West Ham,30,1993,30.0,1,1,1,0,0,1,3,33.3,2,0,0,0,1,2,16,0,Matches
32,Lorenz Assignon,tg,DF,Burnley,23,2000,13.7,35,17,18,13,4,14,27,51.9,13,22,7,15,19,54,43,1,Matches
33,Serge Aurier,ci,"DF,MF",Nott'ham Forest,30,1992,9.3,20,14,9,11,0,5,11,45.5,6,10,3,7,9,29,36,1,Matches
34,Taiwo Awoniyi,ng,FW,Nott'ham Forest,25,1997,11.6,9,7,1,4,4,1,2,50.0,1,7,2,5,1,10,9,0,Matches
35,Jordan Ayew,gh,"FW,MF",Crystal Palace,31,1991,28.3,65,36,23,28,14,21,42,50.0,21,43,2,41,16,81,15,0,Matches
36,Benoît Badiashile,fr,DF,Chelsea,22,2001,14.9,21,15,12,9,0,9,14,64.3,5,21,14,7,18,39,66,2,Matches
37,Leon Bailey,jm,"MF,FW",Aston Villa,25,1997,23.0,13,7,7,4,2,5,20,25.0,15,18,1,17,9,22,6,0,Matches
38,Stefan Bajcetic,es,MF,Liverpool,18,2004,0.3,4,1,3,1,0,3,5,60.0,2,0,0,0,0,4,0,0,Matches
39,George Baldock,gr,DF,Sheffield Utd,30,1993,10.8,18,10,10,7,1,6,15,40.0,9,14,8,6,10,28,33,0,Matches
40,Carlos Baleba,cm,MF,Brighton,19,2004,14.7,40,20,17,19,4,23,46,50.0,23,35,7,28,18,58,30,3,Matches
41,Fodé Ballo-Touré,sn,"DF,MF",Fulham,26,1997,0.8,4,2,1,3,0,1,2,50.0,1,1,0,1,3,7,2,0,Matches
42,Shandon Baptiste,gd,MF,Brentford,25,1998,2.5,4,4,2,2,0,1,5,20.0,4,5,1,4,3,7,6,0,Matches
43,Valentín Barco,ar,"DF,FW",Brighton,19,2004,3.4,11,5,4,5,2,6,8,75.0,2,3,0,3,4,15,3,1,Matches
44,Ross Barkley,eng,MF,Luton Town,29,1993,29.1,47,19,16,21,10,11,48,22.9,37,25,9,16,25,72,51,2,Matches
45,Harvey Barnes,eng,"FW,MF",Newcastle Utd,25,1997,8.9,6,1,3,2,1,1,2,50.0,1,1,0,1,5,11,3,0,Matches
46,Chris Basham,eng,"DF,MF",Sheffield Utd,35,1988,3.6,7,2,4,3,0,2,9,22.2,7,9,4,5,5,12,17,0,Matches
47,Calvin Bassey,ng,DF,Fulham,23,1999,25.6,49,29,33,15,1,21,29,72.4,8,32,11,21,28,77,84,4,Matches
48,Owen Beck,wls,DF,Liverpool,20,2002,0.1,2,1,1,1,0,0,0,,0,0,0,0,0,2,1,0,Matches
49,Donny van de Beek,nl,DF,Manchester Utd,26,1997,0.0,0,0,0,0,0,0,0,,0,1,0,1,0,0,0,0,Matches
50,Amari'i Bell,jm,DF,Luton Town,29,1994,19.1,50,33,30,19,1,22,35,62.9,13,33,15,18,25,75,60,1,Matches
51,Jean-Ricner Bellegarde,fr,"MF,FW",Wolves,25,1998,10.6,17,10,9,6,2,7,15,46.7,8,18,2,16,8,25,14,0,Matches
52,Anis Ben Slimane,tn,MF,Sheffield Utd,22,2001,4.7,11,6,5,2,4,4,10,40.0,6,7,1,6,5,16,7,0,Matches
53,Saïd Benrahma,dz,"FW,MF",West Ham,27,1995,6.9,8,4,5,3,0,4,15,26.7,11,8,0,8,5,13,7,0,Matches
54,Rodrigo Bentancur,uy,MF,Tottenham,26,1997,11.2,23,15,10,11,2,10,24,41.7,14,15,4,11,17,40,16,1,Matches
55,Daniel Bentley,eng,GK,Wolves,30,1993,4.3,0,0,0,0,0,0,1,0.0,1,0,0,0,0,0,1,0,Matches
56,Jóhann Berg Guðmundsson,is,"MF,FW",Burnley,32,1990,13.2,13,4,6,5,2,7,16,43.8,9,14,0,14,16,29,16,0,Matches
57,Sander Berge,no,MF,Burnley,25,1998,33.4,76,46,35,36,5,34,58,58.6,24,49,20,29,23,99,60,2,Matches
58,Luke Berry,eng,"MF,DF",Luton Town,31,1992,3.6,7,2,2,4,1,2,3,66.7,1,6,1,5,0,7,3,0,Matches
59,Beto,gw,FW,Everton,25,1998,10.6,14,6,1,6,7,4,12,33.3,8,11,0,11,1,15,14,0,Matches
60,Jordan Beyer,de,DF,Burnley,23,2000,13.7,35,20,22,12,1,14,24,58.3,10,22,15,7,16,51,68,1,Matches
61,Philip Billing,dk,MF,Bournemouth,27,1996,15.5,33,16,7,22,4,9,27,33.3,18,31,5,26,20,53,28,1,Matches
62,Yves Bissouma,ml,MF,Tottenham,26,1996,23.0,80,52,32,36,12,41,61,67.2,20,28,5,23,37,117,43,3,Matches
63,Benicio Boaitey,eng,"FW,DF",Brighton,19,2004,0.4,0,0,0,0,0,0,1,0.0,1,1,0,1,0,0,2,0,Matches
64,Oscar Bobb,no,"FW,MF",Manchester City,20,2003,3.4,7,3,1,2,4,2,4,50.0,2,4,0,4,5,12,1,0,Matches
65,Jayden Bogle,eng,DF,Sheffield Utd,23,2000,31.0,66,36,43,21,2,35,70,50.0,35,42,11,31,32,98,97,0,Matches
66,Willy Boly,ci,DF,Nott'ham Forest,32,1991,16.0,46,29,36,9,1,22,40,55.0,18,32,21,11,25,71,90,0,Matches
67,Sven Botman,nl,DF,Newcastle Utd,23,2000,15.3,20,13,14,6,0,8,13,61.5,5,20,16,4,9,29,61,3,Matches
68,Jarrod Bowen,eng,FW,West Ham,26,1996,33.5,42,28,14,14,14,13,35,37.1,22,37,5,32,19,61,14,0,Matches
69,Conor Bradley,nir,DF,Liverpool,20,2003,8.4,33,25,14,12,7,24,38,63.2,14,17,1,16,10,43,14,0,Matches
70,Jarrad Branthwaite,eng,DF,Everton,21,2002,34.6,66,32,42,22,2,45,62,72.6,17,51,36,15,50,116,163,2,Matches
71,Ben Brereton,cl,"FW,MF",Sheffield Utd,24,1999,12.3,9,4,4,4,1,4,10,40.0,6,9,3,6,3,12,12,0,Matches
72,Rhian Brewster,eng,"FW,MF",Sheffield Utd,23,2000,3.8,5,1,1,2,2,0,2,0.0,2,2,0,2,1,6,2,0,Matches
73,Armando Broja,al,FW,Chelsea,21,2001,5.0,3,0,0,1,2,1,2,50.0,1,5,1,4,0,3,3,0,Matches
74,Armando Broja,al,FW,Fulham,21,2001,1.0,0,0,0,0,0,0,0,,0,1,0,1,0,0,0,0,Matches
75,Andre Brooks,eng,"MF,DF",Sheffield Utd,19,2003,10.4,22,13,7,11,4,9,21,42.9,12,13,1,12,14,36,20,0,Matches
76,David Brooks,wls,"FW,MF",Bournemouth,26,1997,3.1,5,4,2,1,2,2,4,50.0,2,3,0,3,2,7,2,0,Matches
77,Jacob Brown,sct,"MF,FW",Luton Town,25,1998,11.3,19,12,7,7,5,7,18,38.9,11,20,1,19,8,27,22,0,Matches
78,Josh Brownhill,eng,MF,Burnley,27,1995,25.0,61,35,23,28,10,27,37,73.0,10,33,8,25,34,95,40,1,Matches
79,Jacob Bruun Larsen,dk,"MF,FW",Burnley,24,1998,13.9,9,4,4,3,2,7,21,33.3,14,16,2,14,7,16,23,0,Matches
80,Hugo Bueno,es,"DF,MF",Wolves,20,2002,8.2,21,14,12,7,2,12,19,63.2,7,17,4,13,6,27,24,0,Matches
81,Santiago Bueno,uy,DF,Wolves,24,1998,9.1,13,7,5,7,1,5,11,45.5,6,22,12,10,6,19,33,0,Matches
82,Facundo Buonanotte,ar,"FW,MF",Brighton,18,2004,15.2,42,22,13,22,7,14,44,31.8,30,22,3,19,8,50,5,0,Matches
83,Reece Burke,eng,DF,Luton Town,26,1996,18.4,37,23,17,14,6,12,26,46.2,14,25,18,7,18,55,78,1,Matches
84,Dan Burn,eng,DF,Newcastle Utd,31,1992,30.3,61,33,37,20,4,26,61,42.6,35,55,25,30,37,98,124,1,Matches
85,Mason Burstow,eng,FW,Chelsea,19,2003,0.1,0,0,0,0,0,0,0,,0,0,0,0,0,0,0,0,Matches
86,Moisés Caicedo,ec,MF,Chelsea,21,2001,31.8,91,46,38,42,11,36,60,60.0,24,59,25,34,37,128,44,4,Matches
87,Tom Cairney,sct,MF,Fulham,32,1991,16.5,24,16,10,12,2,13,25,52.0,12,16,4,12,13,37,6,0,Matches
88,Dominic Calvert-Lewin,eng,FW,Everton,26,1997,24.1,13,6,2,6,5,2,15,13.3,13,14,4,10,4,17,38,0,Matches
89,Thomas Cannon,ie,FW,Everton,20,2002,0.0,0,0,0,0,0,0,0,,0,0,0,0,0,0,0,0,Matches
90,Diego Carlos,br,DF,Aston Villa,30,1993,20.2,27,16,22,4,1,13,21,61.9,8,24,19,5,13,40,78,3,Matches
91,Cesare Casadei,it,"FW,MF",Chelsea,20,2003,0.9,5,3,2,1,2,2,5,40.0,3,1,0,1,0,5,4,0,Matches
92,Casemiro,br,"MF,DF",Manchester Utd,31,1992,22.0,83,56,43,32,8,51,106,48.1,55,74,33,41,18,101,71,1,Matches
93,Kaelan Casey,eng,DF,West Ham,18,2004,0.0,0,0,0,0,0,0,0,,0,0,0,0,0,0,1,0,Matches
94,Matty Cash,pl,DF,Aston Villa,25,1997,23.8,54,31,24,24,6,29,59,49.2,30,35,14,21,18,72,59,0,Matches
95,Timothy Castagne,be,DF,Fulham,27,1995,29.3,49,24,23,16,10,26,44,59.1,18,38,10,28,38,87,69,1,Matches
96,Jonny Castro,es,MF,Wolves,29,1994,0.1,0,0,0,0,0,0,1,0.0,1,1,1,0,0,0,0,0,Matches
97,Trevoh Chalobah,eng,DF,Chelsea,24,1999,10.6,16,12,10,2,4,10,15,66.7,5,8,7,1,8,24,51,0,Matches
98,Calum Chambers,eng,"MF,DF",Aston Villa,28,1995,1.7,3,0,3,0,0,0,1,0.0,1,2,1,1,2,5,4,0,Matches
99,Youssef Chermiti,pt,FW,Everton,19,2004,2.3,3,2,2,1,0,1,5,20.0,4,4,1,3,1,4,2,0,Matches
100,Ben Chilwell,eng,DF,Chelsea,26,1996,8.4,15,10,5,9,1,5,8,62.5,3,11,3,8,4,19,19,1,Matches
101,Tawanda Chirewa,zw,"MF,FW",Wolves,19,2003,1.6,7,3,3,3,1,2,3,66.7,1,0,0,0,1,8,0,0,Matches
102,Leon Chiwome,eng,FW,Wolves,17,2006,1.9,2,1,0,1,1,1,2,50.0,1,3,1,2,0,2,2,0,Matches
103,Tahith Chong,nl,"MF,FW",Luton Town,23,1999,22.0,36,22,19,13,4,15,33,45.5,18,30,6,24,8,44,11,1,Matches
104,Ryan Christie,sct,MF,Bournemouth,28,1995,32.3,86,44,34,35,17,39,92,42.4,53,52,11,41,52,138,53,1,Matches
105,Carney Chukwuemeka,eng,"MF,FW",Chelsea,19,2003,2.5,6,4,3,3,0,1,3,33.3,2,1,1,0,0,6,1,0,Matches
106,Bobby Clark,eng,MF,Liverpool,18,2005,1.0,2,1,1,1,0,1,5,20.0,4,6,2,4,1,3,1,0,Matches
107,Jordan Clark,eng,MF,Luton Town,29,1993,14.5,30,17,14,11,5,11,39,28.2,28,24,3,21,11,41,15,1,Matches
108,Nathaniel Clyne,eng,DF,Crystal Palace,32,1991,14.9,24,15,11,11,2,14,21,66.7,7,18,6,12,10,34,33,0,Matches
109,Séamus Coleman,ie,DF,Everton,34,1988,7.4,17,14,10,3,4,11,16,68.8,5,12,4,8,7,24,26,1,Matches
110,Nathan Collins,ie,DF,Brentford,22,2001,29.5,38,20,24,12,2,19,29,65.5,10,46,30,16,44,82,141,4,Matches
111,Levi Colwill,eng,DF,Chelsea,20,2003,20.0,48,30,26,17,5,26,34,76.5,8,28,10,18,26,74,66,0,Matches
112,Lewis Cook,eng,MF,Bournemouth,26,1997,31.0,61,41,24,30,7,34,63,54.0,29,32,11,21,65,126,46,1,Matches
113,Jack Cork,eng,MF,Burnley,34,1989,0.3,2,0,0,2,0,1,3,33.3,2,0,0,0,1,3,1,0,Matches
114,Maxwel Cornet,ci,"MF,FW",West Ham,26,1996,1.2,3,2,3,0,0,1,5,20.0,4,2,0,2,2,5,1,0,Matches
115,Vladimír Coufal,cz,DF,West Ham,30,1992,34.8,64,41,50,12,2,38,75,50.7,37,49,15,34,43,107,97,0,Matches
116,Philippe Coutinho,br,"MF,FW",Aston Villa,31,1992,0.3,0,0,0,0,0,0,1,0.0,1,0,0,0,0,0,0,0,Matches
117,Aaron Cresswell,eng,"DF,FW",West Ham,33,1989,4.8,3,2,1,1,1,2,3,66.7,1,5,3,2,3,6,7,0,Matches
118,Marc Cucurella,es,DF,Chelsea,25,1998,19.8,62,38,36,21,5,34,64,53.1,30,36,13,23,22,84,48,0,Matches
119,Josh Cullen,ie,MF,Burnley,27,1996,22.9,42,29,15,22,5,26,46,56.5,20,31,19,12,15,57,26,1,Matches
120,Matheus Cunha,br,"FW,MF",Wolves,24,1999,27.1,30,16,8,17,5,13,35,37.1,22,28,7,21,13,43,21,1,Matches
121,Sam Curtis,ie,DF,Sheffield Utd,17,2005,0.3,1,0,1,0,0,1,2,50.0,1,2,0,2,0,1,0,0,Matches
122,Mahmoud Dahoud,de,MF,Brighton,27,1996,5.0,9,4,2,4,3,3,9,33.3,6,4,1,3,1,10,5,0,Matches
123,Ameen Al-Dakhil,be,DF,Burnley,21,2002,11.7,12,5,4,7,1,1,10,10.0,9,13,6,7,12,24,38,2,Matches
124,Diogo Dalot,pt,DF,Manchester Utd,24,1999,35.3,81,51,58,12,11,51,74,68.9,23,44,16,28,37,118,111,0,Matches
125,Mikkel Damsgaard,dk,MF,Brentford,23,2000,9.4,29,17,13,9,7,14,40,35.0,26,23,1,22,11,40,10,1,Matches
126,Danilo,br,MF,Nott'ham Forest,22,2001,19.9,36,18,22,12,2,21,46,45.7,25,33,8,25,35,71,42,0,Matches
127,Arnaut Danjuma,nl,"MF,FW",Everton,26,1997,6.6,6,4,2,3,1,1,4,25.0,3,4,0,4,3,9,0,0,Matches
128,Jayden Danns,eng,FW,Liverpool,17,2006,0.1,0,0,0,0,0,0,0,,0,0,0,0,0,0,0,0,Matches
129,Josh Dasilva,eng,"DF,FW",Brentford,24,1998,0.3,2,1,0,1,1,0,0,,0,0,0,0,0,2,0,0,Matches
130,David Datro Fofana,ci,FW,Burnley,20,2002,9.8,10,5,3,5,2,3,6,50.0,3,9,3,6,1,11,2,0,Matches
131,Ben Davies,wls,DF,Tottenham,30,1993,12.1,24,17,13,8,3,16,21,76.2,5,17,15,2,10,34,35,0,Matches
132,Tom Davies,eng,MF,Sheffield Utd,25,1998,2.5,10,5,4,3,3,3,9,33.3,6,2,1,1,3,13,6,1,Matches
133,Craig Dawson,eng,DF,Wolves,33,1990,24.5,30,20,23,6,1,22,34,64.7,12,51,39,12,16,46,120,1,Matches
134,Kevin De Bruyne,be,MF,Manchester City,32,1991,13.6,14,9,1,5,8,7,20,35.0,13,5,0,5,4,18,4,0,Matches
135,Hannes Delcroix,be,DF,Burnley,24,1999,6.5,10,6,6,4,0,3,4,75.0,1,9,3,6,9,19,26,0,Matches
136,Leander Dendoncker,be,MF,Aston Villa,28,1995,1.3,6,4,3,2,1,4,5,80.0,1,5,2,3,2,8,3,1,Matches
137,Moussa Diaby,fr,"FW,MF",Aston Villa,24,1999,24.2,12,5,5,4,3,4,22,18.2,18,8,1,7,9,21,6,0,Matches
138,Amad Diallo,ci,"FW,MF",Manchester Utd,21,2002,4.3,10,3,1,6,3,3,7,42.9,4,3,1,2,1,11,6,0,Matches
139,Amadou Diallo,eng,MF,Newcastle Utd,20,2003,0.0,0,0,0,0,0,0,0,,0,0,0,0,0,0,0,0,Matches
140,Rúben Dias,pt,DF,Manchester City,26,1997,28.4,39,20,14,21,4,19,26,73.1,7,32,17,15,30,69,77,0,Matches
141,Luis Díaz,co,FW,Liverpool,26,1997,29.2,35,25,5,17,13,7,30,23.3,23,15,0,15,3,38,8,0,Matches
142,Eric Dier,eng,DF,Tottenham,29,1994,2.2,2,1,2,0,0,2,2,100.0,0,3,3,0,2,4,12,0,Matches
143,Lucas Digne,fr,DF,Aston Villa,30,1993,26.8,47,19,35,9,3,25,44,56.8,19,20,2,18,26,73,67,0,Matches
144,Issa Diop,fr,DF,Fulham,26,1997,15.8,30,16,23,5,2,15,20,75.0,5,28,19,9,17,47,80,1,Matches
145,Axel Disasi,fr,DF,Chelsea,25,1998,28.7,33,19,20,10,3,23,30,76.7,7,26,19,7,18,51,102,2,Matches
146,Ben Doak,sct,FW,Liverpool,17,2005,0.2,0,0,0,0,0,0,0,,0,0,0,0,0,0,0,0,Matches
147,Lewis Dobbin,eng,MF,Everton,20,2003,2.6,9,7,3,5,1,5,9,55.6,4,5,1,4,1,10,0,0,Matches
148,Matt Doherty,ie,"DF,MF",Wolves,31,1992,12.8,31,18,17,10,4,12,23,52.2,11,15,5,10,7,38,47,0,Matches
149,Jeremy Doku,be,"FW,MF",Manchester City,21,2002,17.7,39,22,13,12,14,9,20,45.0,11,14,0,14,9,48,5,0,Matches
150,Nicolás Domínguez,ar,"MF,FW",Nott'ham Forest,25,1998,16.6,63,34,35,27,1,23,48,47.9,25,31,5,26,18,81,24,0,Matches
151,Jamie Donley,eng,FW,Tottenham,18,2005,0.0,0,0,0,0,0,0,0,,0,0,0,0,0,0,3,0,Matches
152,Abdoulaye Doucouré,ml,"FW,MF",Everton,30,1993,29.2,43,27,20,14,9,18,46,39.1,28,23,3,20,15,58,19,0,Matches
153,Cheick Doucouré,ml,MF,Crystal Palace,23,2000,10.2,34,17,15,13,6,18,30,60.0,12,13,2,11,20,54,12,0,Matches
154,Alfie Doughty,eng,DF,Luton Town,23,1999,32.5,63,40,29,18,16,37,82,45.1,45,51,9,42,31,94,43,4,Matches
155,Tommy Doyle,eng,MF,Wolves,21,2001,13.6,26,13,11,10,5,14,23,60.9,9,22,9,13,12,38,18,0,Matches
156,Radu Drăgușin,ro,DF,Tottenham,21,2002,4.8,5,3,5,0,0,3,3,100.0,0,5,4,1,8,13,19,0,Matches
157,Martin Dúbravka,sk,GK,Newcastle Utd,34,1989,22.1,0,0,0,0,0,0,4,0.0,4,0,0,0,0,0,8,1,Matches
158,Paul Dummett,wls,DF,Newcastle Utd,31,1991,0.2,1,0,1,0,0,1,1,100.0,0,0,0,0,0,1,1,0,Matches
159,Lewis Dunk,eng,DF,Brighton,31,1991,31.9,27,14,17,9,1,13,36,36.1,23,49,37,12,31,58,90,1,Matches
160,Jhon Durán,co,"FW,MF",Aston Villa,19,2003,5.3,6,5,3,1,2,1,6,16.7,5,6,0,6,1,7,10,0,Matches
161,George Earthy,eng,FW,West Ham,18,2004,0.4,0,0,0,0,0,0,1,0.0,1,0,0,0,1,1,0,0,Matches
162,Ederson,br,GK,Manchester City,29,1993,30.9,0,0,0,0,0,0,1,0.0,1,0,0,0,0,0,10,1,Matches
163,Odsonne Édouard,fr,"FW,MF",Crystal Palace,25,1998,17.3,24,12,8,8,8,4,19,21.1,15,17,1,16,6,30,19,0,Matches
164,John Egan,ie,DF,Sheffield Utd,30,1992,5.4,6,4,4,2,0,4,11,36.4,7,10,4,6,13,19,39,1,Matches
165,Hjalmar Ekdal,se,DF,Burnley,24,1998,4.9,4,2,2,2,0,2,4,50.0,2,10,5,5,6,10,21,0,Matches
166,Anthony Elanga,se,"FW,MF",Nott'ham Forest,21,2002,27.0,33,19,20,6,7,17,36,47.2,19,22,2,20,8,41,20,1,Matches
167,Harvey Elliott,eng,"MF,FW",Liverpool,20,2003,15.0,27,17,8,14,5,10,31,32.3,21,27,0,27,6,33,7,0,Matches
168,Mohamed Elneny,eg,MF,Arsenal,31,1992,0.3,0,0,0,0,0,0,1,0.0,1,0,0,0,1,1,0,0,Matches
169,Emerson,br,DF,Tottenham,24,1999,12.9,36,24,23,10,3,21,43,48.8,22,23,10,13,20,56,50,1,Matches
170,Julio Enciso,py,"MF,FW",Brighton,19,2004,5.3,6,2,3,2,1,2,7,28.6,5,11,0,11,0,6,3,0,Matches
171,Wataru Endo,jp,MF,Liverpool,30,1993,19.1,48,28,11,31,6,20,61,32.8,41,24,2,22,20,68,31,3,Matches
172,Christian Eriksen,dk,MF,Manchester Utd,31,1992,12.7,18,13,5,10,3,12,33,36.4,21,17,6,11,4,22,13,0,Matches
173,Maxime Estève,fr,DF,Burnley,21,2002,14.5,27,10,15,12,0,18,32,56.3,14,21,10,11,27,54,56,0,Matches
174,Pervis Estupiñán,ec,DF,Brighton,25,1998,13.8,26,13,12,11,3,14,30,46.7,16,14,4,10,21,47,20,0,Matches
175,Jonny Evans,nir,DF,Manchester Utd,35,1988,15.5,22,14,20,2,0,12,21,57.1,9,25,18,7,23,45,76,0,Matches
176,Eberechi Eze,eng,"MF,FW",Crystal Palace,25,1998,22.8,35,17,4,18,13,15,31,48.4,16,27,2,25,11,46,6,0,Matches
177,Łukasz Fabiański,pl,GK,West Ham,38,1985,8.0,1,0,1,0,0,1,2,50.0,1,0,0,0,1,2,4,0,Matches
178,Romain Faivre,fr,"MF,FW",Bournemouth,25,1998,0.5,1,1,0,1,0,0,3,0.0,3,0,0,0,0,1,0,0,Matches
179,Ansu Fati,es,"MF,FW",Brighton,20,2002,5.8,5,3,1,2,2,1,11,9.1,10,8,0,8,3,8,3,0,Matches
180,Felipe,br,DF,Nott'ham Forest,34,1989,4.2,12,9,9,3,0,9,12,75.0,3,4,1,3,4,16,12,0,Matches
181,Evan Ferguson,ie,FW,Brighton,18,2004,15.2,14,6,4,7,3,5,14,35.7,9,10,3,7,2,16,8,0,Matches
182,Bruno Fernandes,pt,"MF,FW",Manchester Utd,28,1994,34.6,68,38,27,25,16,30,88,34.1,58,49,6,43,27,95,50,2,Matches
183,Enzo Fernández,ar,MF,Chelsea,22,2001,24.5,50,22,22,18,10,27,65,41.5,38,36,13,23,17,67,28,0,Matches
184,John Fleck,sct,"MF,DF",Sheffield Utd,31,1991,1.0,1,0,0,1,0,0,1,0.0,1,0,0,0,0,1,1,0,Matches
185,Mark Flekken,nl,GK,Brentford,30,1993,36.5,1,1,1,0,0,1,5,20.0,4,1,0,1,0,1,17,1,Matches
186,Phil Foden,eng,"FW,MF",Manchester City,23,2000,31.7,31,20,11,10,10,13,31,41.9,18,30,0,30,13,44,18,1,Matches
187,Wes Foderingham,eng,GK,Sheffield Utd,32,1991,29.4,5,3,5,0,0,5,6,83.3,1,0,0,0,0,5,18,6,Matches
188,Pablo Fornals,es,"MF,FW",West Ham,27,1996,4.7,10,6,4,3,3,5,16,31.3,11,8,1,7,6,16,7,0,Matches
189,Omari Forson,eng,FW,Manchester Utd,19,2004,0.8,2,0,0,2,0,1,1,100.0,0,0,0,0,0,2,0,0,Matches
190,Lyle Foster,za,"FW,MF",Burnley,22,2000,21.1,19,10,5,6,8,6,17,35.3,11,13,3,10,3,22,34,0,Matches
191,Matheus França,br,"MF,FW",Crystal Palace,19,2004,2.6,3,3,2,1,0,1,7,14.3,6,4,0,4,1,4,1,0,Matches
192,Nathan Fraser,ie,FW,Wolves,18,2005,2.1,5,2,2,1,2,1,3,33.3,2,2,1,1,1,6,2,0,Matches
193,Cody Gakpo,nl,"FW,MF",Liverpool,24,1999,18.3,27,17,8,14,5,8,25,32.0,17,21,4,17,14,41,7,0,Matches
194,Conor Gallagher,eng,MF,Chelsea,23,2000,34.8,85,52,37,31,17,33,77,42.9,44,50,11,39,43,128,34,0,Matches
195,Idrissa Gana Gueye,sn,MF,Everton,33,1989,20.9,73,44,32,27,14,29,46,63.0,17,24,7,17,28,101,16,0,Matches
196,Alejandro Garnacho,ar,FW,Manchester Utd,19,2004,28.5,22,15,7,6,9,12,45,26.7,33,26,2,24,18,40,18,0,Matches
197,James Garner,eng,MF,Everton,22,2001,33.4,83,44,32,38,13,35,82,42.7,47,45,14,31,45,128,47,1,Matches
198,Saman Ghoddos,ir,DF,Brentford,29,1993,8.2,28,19,19,7,2,17,31,54.8,14,9,2,7,5,33,12,0,Matches
199,Morgan Gibbs-White,eng,"MF,FW",Nott'ham Forest,23,2000,35.1,36,24,6,20,10,14,33,42.4,19,31,8,23,17,53,21,0,Matches
200,Bryan Gil,es,"FW,MF",Tottenham,22,2001,2.3,1,0,0,0,1,1,4,25.0,3,3,0,3,3,4,4,0,Matches
201,Alfie Gilchrist,eng,DF,Chelsea,19,2003,2.3,4,0,4,0,0,2,5,40.0,3,6,3,3,3,7,11,0,Matches
202,Billy Gilmour,sct,MF,Brighton,22,2001,23.6,26,16,14,10,2,11,35,31.4,24,23,9,14,11,37,14,1,Matches
203,Ben Godfrey,eng,DF,Everton,25,1998,12.4,30,20,17,8,5,15,28,53.6,13,14,8,6,16,46,57,0,Matches
204,André Gomes,pt,"MF,FW",Everton,30,1993,5.6,7,4,2,3,2,3,13,23.1,10,10,1,9,3,10,4,1,Matches
205,João Gomes,br,MF,Wolves,22,2001,29.4,128,74,67,49,12,44,99,44.4,55,51,8,43,18,146,29,2,Matches
206,Toti Gomes,pt,DF,Wolves,24,1999,30.8,44,25,32,8,4,24,37,64.9,13,40,19,21,26,70,93,2,Matches
207,Joe Gomez,eng,DF,Liverpool,26,1997,19.8,47,31,24,16,7,30,63,47.6,33,26,4,22,19,66,50,2,Matches
208,Sergio Gómez,es,"FW,MF",Manchester City,22,2000,0.6,1,0,0,1,0,1,2,50.0,1,0,0,0,1,2,0,0,Matches
209,Enso Gonzalez,py,"MF,DF",Wolves,18,2005,0.0,0,0,0,0,0,0,1,0.0,1,0,0,0,0,0,0,0,Matches
210,Anthony Gordon,eng,FW,Newcastle Utd,22,2001,32.1,55,34,16,28,11,22,64,34.4,42,27,0,27,7,62,7,0,Matches
211,Kaide Gordon,eng,FW,Liverpool,18,2004,0.0,0,0,0,0,0,0,0,,0,0,0,0,0,0,0,0,Matches
212,Daniel Gore,eng,MF,Manchester Utd,18,2004,0.0,1,1,0,1,0,1,1,100.0,0,0,0,0,1,2,0,0,Matches
213,Ryan Gravenberch,nl,MF,Liverpool,21,2002,12.5,26,12,5,13,8,12,29,41.4,17,20,2,18,14,40,11,0,Matches
214,Ivo Grbić,hr,GK,Sheffield Utd,27,1996,8.6,0,0,0,0,0,0,1,0.0,1,1,0,1,0,0,9,1,Matches
215,Jack Grealish,eng,"FW,MF",Manchester City,27,1995,11.2,13,8,6,7,0,6,12,50.0,6,13,2,11,6,19,5,0,Matches
216,Pascal Groß,de,"MF,DF",Brighton,32,1991,34.6,70,46,33,21,16,31,72,43.1,41,41,8,33,22,92,32,3,Matches
217,Marc Guéhi,eng,DF,Crystal Palace,23,2000,22.5,28,19,21,7,0,14,24,58.3,10,22,17,5,18,46,89,1,Matches
218,Bruno Guimarães,br,MF,Newcastle Utd,25,1997,36.3,88,53,45,32,11,40,77,51.9,37,52,14,38,35,123,20,0,Matches
219,Malo Gusto,fr,DF,Chelsea,20,2003,19.5,55,27,34,15,6,35,52,67.3,17,28,4,24,17,72,43,1,Matches
220,Joško Gvardiol,hr,DF,Manchester City,21,2002,25.9,55,33,21,24,10,21,38,55.3,17,36,12,24,27,82,37,3,Matches
221,Erling Haaland,no,FW,Manchester City,23,2000,28.4,6,3,0,3,3,2,3,66.7,1,11,1,10,2,8,16,0,Matches
222,Antwoine Hackford,eng,FW,Sheffield Utd,19,2004,0.1,0,0,0,0,0,0,0,,0,0,0,0,0,0,0,0,Matches
223,Lewis Hall,eng,DF,Newcastle Utd,18,2004,8.7,28,18,17,10,1,17,28,60.7,11,17,2,15,12,40,22,1,Matches
224,Gustavo Hamer,nl,MF,Sheffield Utd,26,1997,32.3,39,21,17,15,7,16,59,27.1,43,33,9,24,29,68,35,0,Matches
225,Luke Harris,wls,MF,Fulham,18,2005,0.8,1,1,1,0,0,0,1,0.0,1,0,0,0,0,1,0,0,Matches
226,Jack Harrison,eng,"MF,FW",Everton,26,1996,24.6,37,22,12,12,13,17,49,34.7,32,25,5,20,12,49,24,0,Matches
227,Daiki Hashioka,jp,DF,Luton Town,24,1999,6.6,11,5,6,4,1,5,11,45.5,6,12,7,5,8,19,20,0,Matches
228,Kai Havertz,de,"MF,FW",Arsenal,24,1999,29.3,35,15,7,21,7,14,39,35.9,25,26,1,25,20,55,22,0,Matches
229,Jan Paul van Hecke,nl,DF,Brighton,23,2000,26.3,47,26,25,19,3,27,45,60.0,18,49,27,22,30,77,76,4,Matches
230,Hwang Hee-chan,kr,"FW,MF",Wolves,27,1996,23.5,20,10,11,8,1,9,24,37.5,15,19,1,18,10,30,9,0,Matches
231,Dean Henderson,eng,GK,Crystal Palace,26,1997,18.0,1,1,1,0,0,1,2,50.0,1,0,0,0,0,1,8,2,Matches
232,Rico Henry,eng,DF,Brentford,26,1997,4.5,7,5,3,3,1,6,7,85.7,1,8,3,5,5,12,5,1,Matches
233,Son Heung-min,kr,FW,Tottenham,31,1992,32.6,21,13,6,7,8,10,21,47.6,11,4,1,3,8,29,4,0,Matches
234,Aaron Hickey,sct,DF,Brentford,21,2002,7.9,16,9,9,3,4,7,7,100.0,0,7,3,4,3,19,10,0,Matches
235,James Hill,eng,DF,Bournemouth,21,2002,0.8,3,2,1,2,0,1,1,100.0,0,3,2,1,3,6,8,0,Matches
236,Jack Hinshelwood,eng,DF,Brighton,18,2005,9.7,14,5,7,4,3,5,13,38.5,8,6,2,4,14,28,18,0,Matches
237,Mason Holgate,eng,DF,Sheffield Utd,26,1996,7.9,12,7,5,6,1,5,12,41.7,7,12,5,7,11,23,40,0,Matches
238,Callum Hudson-Odoi,eng,"FW,MF",Nott'ham Forest,22,2000,20.6,18,8,4,5,9,7,28,25.0,21,16,1,15,7,25,12,1,Matches
239,Will Hughes,eng,MF,Crystal Palace,28,1995,21.0,61,33,30,20,11,24,48,50.0,24,36,14,22,21,82,25,0,Matches
240,Pierre Højbjerg,dk,MF,Tottenham,27,1995,14.6,32,18,13,17,2,13,34,38.2,21,21,7,14,19,51,30,3,Matches
241,Rasmus Højlund,dk,FW,Manchester Utd,20,2003,24.0,11,7,2,3,6,5,13,38.5,8,9,1,8,1,12,19,0,Matches
242,Igor,br,DF,Brighton,25,1998,18.2,25,18,7,16,2,17,29,58.6,12,22,9,13,14,39,52,1,Matches
243,Danny Ings,eng,FW,West Ham,31,1992,4.5,6,2,0,6,0,4,13,30.8,9,4,1,3,3,9,7,0,Matches
244,Tim Iroegbunam,eng,MF,Aston Villa,20,2003,1.8,7,5,4,2,1,4,9,44.4,5,3,0,3,2,9,3,0,Matches
245,Alexander Isak,se,FW,Newcastle Utd,23,1999,25.1,5,0,2,1,2,2,8,25.0,6,16,1,15,6,11,13,0,Matches
246,Alex Iwobi,ng,MF,Everton,27,1996,1.6,2,0,1,0,1,2,3,66.7,1,2,0,2,1,3,0,0,Matches
247,Alex Iwobi,ng,"FW,MF",Fulham,27,1996,24.4,29,18,12,15,2,12,25,48.0,13,16,0,16,14,43,9,0,Matches
248,Nicolas Jackson,sn,FW,Chelsea,22,2001,31.1,21,13,5,8,8,5,24,20.8,19,20,5,15,4,25,17,0,Matches
249,Reece James,eng,DF,Chelsea,23,1999,4.7,14,9,10,3,1,8,10,80.0,2,4,4,0,3,17,7,1,Matches
250,Vitaly Janelt,de,"MF,DF",Brentford,25,1998,33.9,63,38,29,25,9,32,64,50.0,32,35,9,26,36,99,64,3,Matches
251,Daniel Jebbison,eng,FW,Sheffield Utd,19,2003,0.2,0,0,0,0,0,0,0,,0,1,0,1,0,0,0,0,Matches
252,Mathias Jensen,dk,MF,Brentford,27,1996,24.5,54,32,25,22,7,26,95,27.4,69,41,6,35,23,77,25,1,Matches
253,Gabriel Jesus,br,FW,Arsenal,26,1997,16.4,24,17,11,5,8,5,18,27.8,13,23,1,22,13,37,12,0,Matches
254,Raúl Jiménez,mx,FW,Fulham,32,1991,15.5,18,12,4,8,6,7,20,35.0,13,11,3,8,4,22,13,0,Matches
255,João Pedro,br,"FW,MF",Brighton,21,2001,22.7,31,14,10,13,8,14,24,58.3,10,15,2,13,11,42,28,0,Matches
256,Joelinton,br,"MF,FW",Newcastle Utd,26,1996,14.2,39,27,21,15,3,14,38,36.8,24,23,7,16,19,58,11,1,Matches
257,Ryan John Giles,eng,"DF,MF",Luton Town,23,2000,5.6,8,6,4,3,1,2,7,28.6,5,2,0,2,4,12,22,0,Matches
258,Ben Johnson,eng,"DF,FW",West Ham,23,2000,6.0,11,7,7,3,1,9,14,64.3,5,2,1,1,5,16,14,0,Matches
259,Brennan Johnson,wls,FW,Tottenham,22,2001,23.2,26,15,14,5,7,12,31,38.7,19,37,1,36,10,36,12,1,Matches
260,Brennan Johnson,wls,"FW,MF",Nott'ham Forest,22,2001,2.6,4,1,1,1,2,2,4,50.0,2,4,1,3,0,4,0,0,Matches
261,Joseph Johnson,eng,DF,Luton Town,17,2006,0.9,0,0,0,0,0,0,1,0.0,1,0,0,0,0,0,0,0,Matches
262,Sam Johnstone,eng,GK,Crystal Palace,30,1993,20.0,1,0,1,0,0,1,1,100.0,0,0,0,0,1,2,5,0,Matches
263,Curtis Jones,eng,MF,Liverpool,22,2001,13.0,27,14,12,12,3,10,23,43.5,13,22,0,22,7,34,8,0,Matches
264,Jorginho,it,MF,Arsenal,31,1991,10.2,24,10,6,10,8,11,23,47.8,12,17,1,16,12,36,7,1,Matches
265,Diogo Jota,pt,FW,Liverpool,26,1996,12.7,23,13,6,13,4,10,23,43.5,13,9,1,8,7,30,4,0,Matches
266,Mads Juel Andersen,dk,DF,Luton Town,25,1997,4.4,6,5,4,2,0,4,4,100.0,0,9,6,3,8,14,29,0,Matches
267,Hamed Junior Traorè,ci,MF,Bournemouth,23,2000,0.5,1,0,1,0,0,1,3,33.3,2,3,0,3,0,1,0,0,Matches
268,Mathias Jørgensen,dk,DF,Brentford,33,1990,12.1,17,12,15,1,1,11,19,57.9,8,9,5,4,12,29,40,0,Matches
269,Issa Kaboré,bf,DF,Luton Town,22,2001,19.2,52,28,23,21,8,24,45,53.3,21,22,11,11,16,68,56,2,Matches
270,Sasa Kalajdzic,at,FW,Wolves,26,1997,1.8,6,2,3,2,1,1,2,50.0,1,3,0,3,1,7,6,0,Matches
271,Boubacar Kamara,fr,MF,Aston Villa,23,1999,18.4,43,29,16,21,6,24,47,51.1,23,21,7,14,21,64,16,0,Matches
272,Willy Kambwala,fr,DF,Manchester Utd,18,2004,3.7,3,1,1,2,0,1,3,33.3,2,6,3,3,4,7,14,1,Matches
273,Thomas Kaminski,be,GK,Luton Town,30,1992,37.8,2,1,2,0,0,2,6,33.3,4,1,0,1,0,2,14,2,Matches
274,Loris Karius,de,GK,Newcastle Utd,30,1993,1.0,0,0,0,0,0,0,0,,0,0,0,0,0,0,1,0,Matches
275,Michael Keane,eng,DF,Everton,30,1993,4.9,7,3,3,3,1,1,7,14.3,6,5,4,1,5,12,18,1,Matches
276,Thilo Kehrer,de,"DF,MF",West Ham,26,1996,0.2,1,1,0,1,0,0,0,,0,2,2,0,0,1,0,0,Matches
277,Caoimhín Kelleher,ie,GK,Liverpool,24,1998,10.0,0,0,0,0,0,0,0,,0,0,0,0,0,0,4,1,Matches
278,Lloyd Kelly,eng,DF,Bournemouth,24,1998,17.3,24,19,10,9,5,14,25,56.0,11,22,12,10,13,37,67,0,Matches
279,Omari Kellyman,eng,FW,Aston Villa,17,2005,0.4,1,0,0,1,0,1,2,50.0,1,0,0,0,0,1,0,0,Matches
280,Milos Kerkez,hu,DF,Bournemouth,19,2003,21.9,47,26,31,13,3,30,42,71.4,12,31,11,20,20,67,60,2,Matches
281,Kaine Kesler-Hayden,eng,"MF,DF",Aston Villa,20,2002,0.1,0,0,0,0,0,0,0,,0,0,0,0,0,0,0,0,Matches
282,Max Kilman,eng,DF,Wolves,26,1997,38.0,47,21,40,6,1,24,32,75.0,8,64,37,27,39,86,182,4,Matches
283,Jakub Kiwior,pl,DF,Arsenal,23,2000,10.5,20,12,11,8,1,14,19,73.7,5,11,3,8,8,28,28,1,Matches
284,Justin Kluivert,nl,"MF,FW",Bournemouth,24,1999,21.3,28,14,5,12,11,8,30,26.7,22,16,1,15,8,36,11,0,Matches
285,Luca Koleosho,it,"MF,FW",Burnley,18,2004,10.8,7,4,2,5,0,2,10,20.0,8,13,0,13,2,9,0,0,Matches
286,Ibrahima Konaté,fr,DF,Liverpool,24,1999,17.5,36,22,22,13,1,18,24,75.0,6,18,12,6,20,56,51,1,Matches
287,Ezri Konsa,eng,DF,Aston Villa,25,1997,34.1,54,32,28,23,3,23,27,85.2,4,36,20,16,28,82,73,3,Matches
288,Cheikhou Kouyaté,sn,MF,Nott'ham Forest,33,1989,2.4,8,5,3,3,2,1,4,25.0,3,4,1,3,2,10,10,0,Matches
289,Mateo Kovačić,hr,MF,Manchester City,29,1994,17.2,36,25,16,15,5,18,28,64.3,10,23,1,22,10,46,10,0,Matches
290,Emil Krafth,se,DF,Newcastle Utd,28,1994,10.1,21,14,10,7,4,12,25,48.0,13,8,3,5,9,30,21,0,Matches
291,Mohammed Kudus,gh,"FW,MF",West Ham,22,2000,27.6,65,47,27,27,11,20,40,50.0,20,25,0,25,11,76,9,1,Matches
292,Dejan Kulusevski,se,"FW,MF",Tottenham,23,2000,30.7,62,33,19,20,23,25,67,37.3,42,24,1,23,18,80,2,1,Matches
293,Adam Lallana,eng,"MF,FW",Brighton,35,1988,9.4,8,3,4,4,0,0,4,0.0,4,2,1,1,3,11,1,0,Matches
294,Tariq Lamptey,gh,"DF,FW",Brighton,22,2000,10.2,21,14,14,5,2,13,22,59.1,9,7,3,4,6,27,6,0,Matches
295,Aymeric Laporte,es,DF,Manchester City,29,1994,0.1,0,0,0,0,0,0,0,,0,1,1,0,0,0,1,0,Matches
296,Yasser Larouci,dz,DF,Sheffield Utd,22,2001,5.9,17,9,10,5,2,10,14,71.4,4,6,1,5,7,24,20,1,Matches
297,Jamaal Lascelles,eng,DF,Newcastle Utd,29,1993,12.0,14,9,7,7,0,6,11,54.5,5,17,12,5,5,19,42,0,Matches
298,Roméo Lavia,be,MF,Chelsea,19,2004,0.4,1,0,0,1,0,0,0,,0,0,0,0,0,1,1,0,Matches
299,Mario Lemina,ga,MF,Wolves,29,1993,33.0,90,58,46,33,11,25,47,53.2,22,36,9,27,41,131,64,0,Matches
300,Clément Lenglet,fr,DF,Aston Villa,28,1995,12.8,13,9,7,5,1,7,13,53.8,6,19,11,8,7,20,47,1,Matches
301,Bernd Leno,de,GK,Fulham,31,1992,38.0,0,0,0,0,0,0,0,,0,0,0,0,0,0,14,1,Matches
302,Jefferson Lerma,co,"MF,DF",Crystal Palace,28,1994,26.7,42,25,15,23,4,19,40,47.5,21,31,12,19,36,78,72,0,Matches
303,Rico Lewis,eng,"DF,MF",Manchester City,18,2004,9.0,10,7,4,4,2,3,7,42.9,4,7,1,6,4,14,6,0,Matches
304,Keane Lewis-Potter,eng,"FW,DF",Brentford,22,2001,16.0,17,7,5,11,1,7,15,46.7,8,10,2,8,7,24,23,0,Matches
305,Victor Lindelöf,se,DF,Manchester Utd,29,1994,14.8,15,10,8,7,0,5,13,38.5,8,18,9,9,12,27,40,1,Matches
306,Valentino Livramento,eng,DF,Newcastle Utd,20,2002,14.6,23,13,15,6,2,10,21,47.6,11,16,7,9,25,48,41,1,Matches
307,Giovani Lo Celso,ar,MF,Tottenham,27,1996,5.6,22,13,10,8,4,9,14,64.3,5,4,1,3,5,27,2,0,Matches
308,Tom Lockyer,wls,DF,Luton Town,28,1994,13.0,25,16,17,6,2,15,22,68.2,7,23,13,10,23,48,68,0,Matches
309,Sean Longstaff,eng,MF,Newcastle Utd,25,1997,30.5,54,30,17,29,8,24,63,38.1,39,43,7,36,17,71,23,0,Matches
310,Max Lowe,eng,"DF,MF",Sheffield Utd,26,1997,5.6,21,10,13,5,3,8,15,53.3,7,10,4,6,5,26,15,0,Matches
311,Douglas Luiz,br,MF,Aston Villa,25,1998,33.3,58,38,21,27,10,25,53,47.2,28,32,8,24,23,81,18,2,Matches
312,Saša Lukić,rs,MF,Fulham,26,1996,12.5,33,19,9,17,7,18,39,46.2,21,18,5,13,16,49,19,1,Matches
313,Ian Maatsen,nl,"FW,MF",Chelsea,21,2002,2.3,3,2,1,1,1,0,4,0.0,4,4,0,4,3,6,10,0,Matches
314,Alexis Mac Allister,ar,MF,Liverpool,24,1998,28.9,99,55,35,50,14,59,125,47.2,66,65,8,57,35,134,25,1,Matches
315,James Maddison,eng,MF,Tottenham,26,1996,23.7,33,19,5,18,10,15,29,51.7,14,15,3,12,13,46,10,1,Matches
316,Noni Madueke,eng,FW,Chelsea,21,2002,11.7,16,10,8,4,4,11,34,32.4,23,11,0,11,4,20,14,0,Matches
317,Gabriel Magalhães,br,DF,Arsenal,25,1997,33.8,48,28,24,22,2,17,22,77.3,5,44,33,11,31,79,100,1,Matches
318,Harry Maguire,eng,DF,Manchester Utd,30,1993,18.4,24,17,14,10,0,12,22,54.5,10,33,24,9,25,49,83,1,Matches
319,Kobbie Mainoo,eng,MF,Manchester Utd,18,2005,21.4,47,27,20,16,11,21,45,46.7,24,20,12,8,22,69,30,1,Matches
320,Orel Mangala,be,MF,Nott'ham Forest,25,1998,17.4,27,13,16,10,1,14,29,48.3,15,12,6,6,26,53,32,0,Matches
321,Benson Manuel,ao,"MF,FW",Burnley,26,1997,1.3,3,2,2,1,0,0,0,,0,1,0,1,0,3,0,0,Matches
322,Solly March,eng,"FW,DF",Brighton,29,1994,6.2,19,14,9,7,3,8,14,57.1,6,5,0,5,11,30,8,0,Matches
323,Anthony Martial,fr,FW,Manchester Utd,27,1995,5.0,4,1,1,1,2,1,1,100.0,0,4,0,4,0,4,3,0,Matches
324,Gabriel Martinelli,br,FW,Arsenal,22,2001,22.4,30,24,9,12,9,13,32,40.6,19,23,1,22,5,35,9,1,Matches
325,Emiliano Martínez,ar,GK,Aston Villa,30,1992,33.5,0,0,0,0,0,0,0,,0,0,0,0,0,0,12,3,Matches
326,Lisandro Martínez,ar,DF,Manchester Utd,25,1998,7.2,12,8,8,4,0,5,12,41.7,7,10,8,2,5,17,26,0,Matches
327,Han-Noah Massengo,fr,"MF,DF",Burnley,22,2001,0.2,1,1,1,0,0,0,0,,0,1,0,1,0,1,0,0,Matches
328,Pape Matar Sarr,sn,MF,Tottenham,20,2002,23.0,34,24,11,17,6,15,36,41.7,21,21,5,16,31,65,28,1,Matches
329,Jean-Philippe Mateta,fr,FW,Crystal Palace,26,1997,25.4,22,15,4,11,7,6,10,60.0,4,13,4,9,4,26,14,0,Matches
330,Joël Matip,cm,DF,Liverpool,31,1991,8.7,12,6,7,4,1,8,12,66.7,4,16,12,4,9,21,43,0,Matches
331,Alex Matos,eng,MF,Chelsea,18,2004,0.0,0,0,0,0,0,0,0,,0,0,0,0,0,0,0,0,Matches
332,Remi Matthews,eng,GK,Crystal Palace,29,1994,0.0,0,0,0,0,0,0,0,,0,0,0,0,0,0,1,0,Matches
333,Neal Maupay,fr,FW,Brentford,26,1996,14.7,10,7,4,5,1,3,13,23.1,10,11,0,11,2,12,3,0,Matches
334,Neal Maupay,fr,FW,Everton,26,1996,1.2,0,0,0,0,0,0,1,0.0,1,2,0,2,0,0,1,0,Matches
335,Konstantinos Mavropanos,gr,DF,West Ham,25,1997,16.7,28,16,17,9,2,17,21,81.0,4,21,13,8,23,51,79,3,Matches
336,Bryan Mbeumo,cm,FW,Brentford,23,1999,21.8,15,10,6,6,3,5,19,26.3,14,26,2,24,7,22,13,0,Matches
337,James Mcatee,eng,"MF,FW",Sheffield Utd,20,2002,20.2,32,21,9,13,10,13,33,39.4,20,20,0,20,11,43,18,0,Matches
338,James Mcatee,eng,MF,Manchester City,20,2002,0.0,0,0,0,0,0,0,0,,0,1,0,1,0,0,0,0,Matches
339,Oliver McBurnie,sct,FW,Sheffield Utd,27,1996,14.2,17,7,4,7,6,5,12,41.7,7,18,2,16,5,22,28,0,Matches
340,James McConnell,eng,MF,Liverpool,18,2004,0.0,0,0,0,0,0,0,0,,0,1,0,1,1,1,0,0,Matches
341,John McGinn,sct,"MF,FW",Aston Villa,28,1994,33.3,59,35,18,34,7,32,77,41.6,45,33,4,29,21,80,21,0,Matches
342,Scott McKenna,sct,DF,Nott'ham Forest,26,1996,4.6,4,0,3,1,0,2,3,66.7,1,6,4,2,5,9,27,0,Matches
343,Dwight McNeil,eng,"MF,FW",Everton,23,1999,32.1,44,27,16,14,14,24,55,43.6,31,44,7,37,22,66,37,0,Matches
344,Scott McTominay,sct,"MF,FW",Manchester Utd,26,1996,21.1,49,25,23,24,2,22,33,66.7,11,34,12,22,14,63,54,0,Matches
345,Ben Mee,eng,DF,Brentford,33,1989,14.1,26,15,12,12,2,17,22,77.3,5,21,13,8,13,39,63,1,Matches
346,Hannibal Mejbri,tn,"MF,FW",Manchester Utd,20,2003,1.5,3,3,1,2,0,1,3,33.3,2,1,1,0,0,3,0,0,Matches
347,Teden Mengi,eng,DF,Luton Town,21,2002,27.4,54,22,33,20,1,19,30,63.3,11,39,27,12,57,111,140,1,Matches
348,Chris Mepham,wls,DF,Bournemouth,25,1997,6.9,12,11,9,3,0,9,14,64.3,5,13,6,7,7,19,30,1,Matches
349,Lewis Miley,eng,MF,Newcastle Utd,17,2006,13.4,33,21,6,20,7,15,32,46.9,17,20,3,17,8,41,18,2,Matches
350,James Milner,eng,"DF,MF",Brighton,37,1986,8.6,20,14,9,10,1,9,14,64.3,5,9,0,9,8,28,16,0,Matches
351,Tyrone Mings,eng,DF,Aston Villa,30,1993,0.3,0,0,0,0,0,0,0,,0,0,0,0,1,1,1,0,Matches
352,Tyrick Mitchell,eng,"DF,MF",Crystal Palace,23,1999,35.6,105,60,75,21,9,43,60,71.7,17,63,10,53,26,131,104,0,Matches
353,Kaoru Mitoma,jp,FW,Brighton,26,1997,16.5,13,6,3,7,3,5,19,26.3,14,15,1,14,5,18,12,0,Matches
354,Aleksandar Mitrović,rs,FW,Fulham,28,1994,0.4,0,0,0,0,0,0,0,,0,0,0,0,0,0,0,0,Matches
355,Jakub Moder,pl,"MF,DF",Brighton,24,1999,6.9,19,10,9,5,5,9,18,50.0,9,8,2,6,2,21,12,0,Matches
356,Gonzalo Montiel,ar,DF,Nott'ham Forest,26,1997,8.9,22,19,12,8,2,16,29,55.2,13,8,3,5,9,31,31,1,Matches
357,Kieffer Moore,wls,"FW,MF",Bournemouth,30,1992,1.2,0,0,0,0,0,0,0,,0,0,0,0,0,0,0,0,Matches
358,Mikey Moore,eng,MF,Tottenham,15,2007,0.0,0,0,0,0,0,0,0,,0,0,0,0,0,0,1,0,Matches
359,Álex Moreno,es,DF,Aston Villa,30,1993,11.5,18,12,18,0,0,12,19,63.2,7,11,2,9,13,31,37,0,Matches
360,Carlton Morris,eng,"FW,MF",Luton Town,27,1995,31.8,15,8,4,6,5,9,15,60.0,6,24,5,19,1,16,53,0,Matches
361,Mason Mount,eng,"MF,FW",Manchester Utd,24,1999,5.7,22,14,6,10,6,6,16,37.5,10,6,1,5,6,28,3,0,Matches
362,Divin Mubama,eng,FW,West Ham,18,2004,0.9,0,0,0,0,0,0,0,,0,0,0,0,0,0,0,0,Matches
363,Mykhailo Mudryk,ua,FW,Chelsea,22,2001,17.5,21,12,9,7,5,10,32,31.3,22,14,1,13,9,30,9,0,Matches
364,Rodrigo Muniz,br,FW,Fulham,22,2001,17.7,7,3,1,5,1,1,6,16.7,5,9,3,6,6,13,20,0,Matches
365,Daniel Muñoz,co,"DF,MF",Crystal Palace,27,1996,16.0,55,35,31,14,10,19,38,50.0,19,29,7,22,24,79,47,0,Matches
366,Finley Munroe,eng,MF,Aston Villa,18,2005,0.0,0,0,0,0,0,0,0,,0,0,0,0,0,0,0,0,Matches
367,Arijanet Muric,xk,GK,Burnley,24,1998,10.0,1,1,1,0,0,1,1,100.0,0,0,0,0,0,1,10,4,Matches
368,Murillo,br,DF,Nott'ham Forest,21,2002,31.0,50,31,36,13,1,19,33,57.6,14,41,24,17,37,87,188,0,Matches
369,Alex Murphy,ie,"DF,FW",Newcastle Utd,19,2004,0.1,1,1,0,1,0,1,2,50.0,1,1,0,1,1,2,0,0,Matches
370,Jacob Murphy,eng,"FW,DF",Newcastle Utd,28,1995,13.2,20,10,8,4,8,12,26,46.2,14,17,0,17,6,26,16,0,Matches
371,Vitaliy Mykolenko,ua,DF,Everton,24,1999,27.4,69,38,46,21,2,41,66,62.1,25,36,11,25,36,105,92,0,Matches
372,Marvelous Nakamba,zw,MF,Luton Town,29,1994,12.6,40,24,24,14,2,24,42,57.1,18,23,6,17,11,51,11,1,Matches
373,Michael Ndiweni,eng,FW,Newcastle Utd,19,2003,0.0,0,0,0,0,0,0,0,,0,0,0,0,0,0,0,0,Matches
374,Reiss Nelson,eng,FW,Arsenal,23,1999,3.0,9,6,5,1,3,8,10,80.0,2,5,1,4,1,10,5,0,Matches
375,Zack Nelson,eng,"MF,DF",Luton Town,18,2004,0.1,1,0,1,0,0,0,0,,0,0,0,0,0,1,0,0,Matches
376,Neto,br,GK,Bournemouth,34,1989,32.0,0,0,0,0,0,0,0,,0,1,0,1,1,1,12,3,Matches
377,Pedro Neto,pt,"FW,MF",Wolves,23,2000,16.8,7,3,3,2,2,5,15,33.3,10,5,1,4,5,12,2,0,Matches
378,Moussa Niakhate,sn,DF,Nott'ham Forest,27,1996,16.2,42,25,33,9,0,20,25,80.0,5,19,12,7,14,56,51,0,Matches
379,Eddie Nketiah,eng,FW,Arsenal,24,1999,12.0,12,7,2,6,4,2,7,28.6,5,11,0,11,4,16,4,0,Matches
380,Christopher Nkunku,fr,"FW,MF",Chelsea,25,1997,4.9,5,4,0,4,1,1,2,50.0,1,4,1,3,2,7,4,0,Matches
381,Rhys Norrington-Davies,wls,DF,Sheffield Utd,24,1999,1.2,1,1,1,0,0,0,1,0.0,1,2,0,2,1,2,2,0,Matches
382,Oliver Norwood,nir,MF,Sheffield Utd,32,1991,16.0,41,26,18,18,5,20,47,42.6,27,24,9,15,21,62,39,0,Matches
383,Matheus Nunes,pt,MF,Wolves,24,1998,2.0,3,1,3,0,0,2,6,33.3,4,0,0,0,6,9,1,0,Matches
384,Matheus Nunes,pt,MF,Manchester City,24,1998,7.3,10,4,1,7,2,5,16,31.3,11,7,1,6,1,11,8,1,Matches
385,Darwin Núñez,uy,FW,Liverpool,24,1999,22.7,22,12,2,10,10,11,23,47.8,12,18,6,12,3,25,9,0,Matches
386,Ethan Nwaneri,eng,FW,Arsenal,16,2007,0.2,0,0,0,0,0,0,0,,0,1,0,1,0,0,0,0,Matches
387,Christian Nørgaard,dk,MF,Brentford,29,1994,27.8,81,50,42,31,8,32,87,36.8,55,48,6,42,54,135,50,0,Matches
388,Mark O'Mahony,ie,FW,Brighton,18,2005,0.7,1,0,1,0,0,1,2,50.0,1,2,1,1,0,1,1,0,Matches
389,Dara O'Shea,ie,DF,Burnley,24,1999,32.1,39,20,22,14,3,11,26,42.3,15,41,30,11,35,74,158,2,Matches
390,Michael Obafemi,ie,"FW,MF",Burnley,23,2000,0.2,0,0,0,0,0,0,0,,0,1,0,1,0,0,0,0,Matches
391,Wilson Odobert,fr,"MF,FW",Burnley,18,2004,23.3,17,13,8,5,4,6,22,27.3,16,26,2,24,6,23,14,0,Matches
392,Odeluga Offiah,eng,DF,Brighton,20,2002,1.4,1,0,1,0,0,1,1,100.0,0,0,0,0,1,2,0,0,Matches
393,Chiedozie Ogbene,ie,"MF,DF",Luton Town,26,1997,22.2,17,10,10,7,0,12,22,54.5,10,14,3,11,7,24,34,2,Matches
394,Angelo Ogbonna,it,DF,West Ham,35,1988,7.1,11,5,9,2,0,6,7,85.7,1,13,10,3,3,14,29,0,Matches
395,Michael Olakigbe,eng,"DF,FW",Brentford,19,2004,0.7,3,0,2,1,0,2,4,50.0,2,7,0,7,1,4,0,1,Matches
396,Michael Olise,fr,"FW,MF",Crystal Palace,21,2001,14.2,19,10,7,10,2,8,24,33.3,16,21,0,21,11,30,9,0,Matches
397,Robin Olsen,se,GK,Aston Villa,33,1990,4.5,0,0,0,0,0,0,0,,0,0,0,0,0,0,1,0,Matches
398,Andrew Omobamidele,ie,DF,Nott'ham Forest,21,2002,8.7,10,3,9,1,0,5,8,62.5,3,12,8,4,13,23,42,1,Matches
399,Amadou Onana,be,MF,Everton,21,2001,23.2,71,38,32,31,8,21,42,50.0,21,25,6,19,21,92,31,0,Matches
400,André Onana,cm,GK,Manchester Utd,27,1996,38.0,2,0,2,0,0,2,2,100.0,0,0,0,0,0,2,11,2,Matches
401,Ryan One,sct,FW,Sheffield Utd,17,2006,0.1,0,0,0,0,0,0,0,,0,0,0,0,0,0,0,0,Matches
402,Tyler Onyango,eng,MF,Everton,20,2003,0.0,0,0,0,0,0,0,0,,0,0,0,0,0,0,0,0,Matches
403,Fred Onyedinma,eng,"DF,MF",Luton Town,26,1996,4.5,10,6,7,3,0,5,12,41.7,7,3,0,3,1,11,13,0,Matches
404,Frank Onyeka,ng,MF,Brentford,25,1998,12.9,37,24,9,23,5,16,29,55.2,13,15,7,8,23,60,17,0,Matches
405,Divock Origi,be,FW,Nott'ham Forest,28,1995,6.7,6,4,5,0,1,0,0,,0,6,0,6,2,8,4,0,Matches
406,Stefan Ortega,de,GK,Manchester City,30,1992,7.1,0,0,0,0,0,0,0,,0,0,0,0,0,0,2,1,Matches
407,Ben Osborn,eng,"DF,MF",Sheffield Utd,28,1994,15.2,22,9,11,9,2,8,17,47.1,9,18,2,16,8,30,30,0,Matches
408,Gabriel Osho,ng,DF,Luton Town,24,1998,20.5,41,22,21,19,1,16,27,59.3,11,37,20,17,31,72,92,0,Matches
409,William Osula,dk,FW,Sheffield Utd,19,2003,8.7,2,2,1,0,1,1,2,50.0,1,3,1,2,2,4,9,0,Matches
410,Dango Ouattara,bf,"FW,DF",Bournemouth,21,2002,13.7,45,27,22,11,12,19,34,55.9,15,18,3,15,22,67,35,0,Matches
411,David Ozoh,eng,"MF,DF",Crystal Palace,18,2005,1.7,10,6,3,6,1,5,6,83.3,1,2,0,2,0,10,2,0,Matches
412,João Palhinha,pt,MF,Fulham,28,1995,30.0,152,75,80,60,12,103,152,67.8,49,57,9,48,46,198,58,0,Matches
413,Cole Palmer,eng,"FW,MF",Chelsea,21,2002,29.0,23,12,9,6,8,8,19,42.1,11,20,2,18,20,43,13,2,Matches
414,Cole Palmer,eng,MF,Manchester City,21,2002,0.1,0,0,0,0,0,0,0,,0,0,0,0,0,0,0,0,Matches
415,Emerson Palmieri,it,DF,West Ham,28,1994,34.9,106,68,48,42,16,57,90,63.3,33,47,15,32,43,149,96,0,Matches
416,Lucas Paquetá,br,"FW,MF",West Ham,25,1997,29.1,71,48,38,26,7,25,52,48.1,27,28,1,27,21,92,28,2,Matches
417,Ben Parkinson,eng,FW,Newcastle Utd,18,2005,0.3,0,0,0,0,0,0,0,,0,1,0,1,0,0,1,0,Matches
418,Thomas Partey,gh,"MF,DF",Arsenal,30,1993,8.8,14,11,9,4,1,5,10,50.0,5,9,3,6,11,25,9,0,Matches
419,Nathan Patterson,sct,DF,Everton,21,2001,11.2,34,24,21,11,2,14,37,37.8,23,14,3,11,9,43,33,0,Matches
420,Myles Peart-Harris,eng,"DF,MF",Brentford,20,2002,0.1,0,0,0,0,0,0,0,,0,0,0,0,0,0,1,0,Matches
421,Sydie Peck,eng,MF,Sheffield Utd,18,2004,0.1,0,0,0,0,0,0,0,,0,0,0,0,0,0,0,0,Matches
422,Facundo Pellistri,uy,"FW,MF",Manchester Utd,21,2001,1.9,5,3,4,1,0,1,3,33.3,2,7,1,6,1,6,5,0,Matches
423,Andreas Pereira,br,MF,Fulham,27,1996,29.0,25,12,4,12,9,11,41,26.8,30,16,2,14,4,29,12,0,Matches
424,Ivan Perišić,hr,FW,Tottenham,34,1989,1.1,3,2,1,1,1,3,5,60.0,2,1,0,1,2,5,1,0,Matches
425,Đorđe Petrović,rs,GK,Chelsea,23,1999,22.1,0,0,0,0,0,0,0,,0,0,0,0,0,0,12,3,Matches
426,Kalvin Phillips,eng,MF,West Ham,27,1995,3.4,11,6,2,8,1,5,9,55.6,4,4,1,3,4,15,2,1,Matches
427,Kalvin Phillips,eng,MF,Manchester City,27,1995,1.0,3,3,1,1,1,0,0,,0,0,0,0,2,5,2,0,Matches
428,Jaden Philogene Bidace,eng,FW,Aston Villa,21,2002,0.0,0,0,0,0,0,0,0,,0,0,0,0,0,0,0,0,Matches
429,Jordan Pickford,eng,GK,Everton,29,1994,38.0,1,0,1,0,0,1,1,100.0,0,3,0,3,0,1,19,1,Matches
430,Ethan Pinnock,jm,DF,Brentford,30,1993,28.0,35,23,22,13,0,9,20,45.0,11,40,24,16,43,78,170,3,Matches
431,Nick Pope,eng,GK,Newcastle Utd,31,1992,14.9,0,0,0,0,0,0,1,0.0,1,0,0,0,0,0,7,2,Matches
432,Pedro Porro,es,DF,Tottenham,23,1999,34.3,91,63,43,34,14,62,120,51.7,58,63,18,45,34,125,102,3,Matches
433,Jarell Quansah,eng,DF,Liverpool,20,2003,13.2,25,22,17,7,1,14,20,70.0,6,16,8,8,17,42,39,1,Matches
434,Ionuț Radu,ro,GK,Bournemouth,26,1997,2.0,0,0,0,0,0,0,0,,0,0,0,0,0,0,0,0,Matches
435,Jesurun Rak Sakyi,eng,"MF,FW",Crystal Palace,20,2002,1.5,4,1,3,1,0,2,3,66.7,1,2,0,2,3,7,1,0,Matches
436,Aaron Ramsdale,eng,GK,Arsenal,25,1998,6.0,0,0,0,0,0,0,0,,0,0,0,0,0,0,3,2,Matches
437,Aaron Ramsey,eng,"MF,FW",Burnley,20,2003,5.9,17,14,7,5,5,8,16,50.0,8,11,2,9,1,18,10,0,Matches
438,Jacob Ramsey,eng,"FW,MF",Aston Villa,22,2001,9.5,16,8,7,6,3,5,15,33.3,10,15,2,13,3,19,8,0,Matches
439,Marcus Rashford,eng,FW,Manchester Utd,25,1997,25.2,19,12,9,4,6,9,26,34.6,17,15,1,14,4,23,21,0,Matches
440,David Raya,es,GK,Arsenal,27,1995,32.0,1,1,1,0,0,1,1,100.0,0,0,0,0,0,1,8,5,Matches
441,Tim Ream,us,DF,Fulham,35,1987,16.7,20,9,13,5,2,9,18,50.0,9,23,15,8,25,45,61,2,Matches
442,Nathan Redmond,eng,"FW,MF",Burnley,29,1994,1.6,2,1,0,0,2,1,4,25.0,3,1,0,1,0,2,3,0,Matches
443,Harrison Reed,eng,MF,Fulham,28,1995,14.7,29,18,9,17,3,13,31,41.9,18,19,9,10,11,40,24,0,Matches
444,Sergio Reguilón,es,DF,Manchester Utd,26,1996,4.6,13,8,6,2,5,8,17,47.1,9,10,0,10,5,18,7,0,Matches
445,Sergio Reguilón,es,DF,Brentford,26,1996,12.4,45,20,26,18,1,24,40,60.0,16,23,6,17,16,61,41,1,Matches
446,Bobby Reid,jm,FW,Fulham,30,1993,15.8,22,14,5,15,2,4,16,25.0,12,24,2,22,5,27,14,0,Matches
447,Gio Reyna,us,"FW,MF",Nott'ham Forest,20,2002,2.6,7,3,4,0,3,3,6,50.0,3,3,0,3,2,9,0,0,Matches
448,Rodrigo Ribeiro,pt,"MF,FW",Nott'ham Forest,18,2005,0.2,0,0,0,0,0,0,1,0.0,1,1,0,1,1,1,0,0,Matches
449,Declan Rice,eng,MF,Arsenal,24,1999,35.8,83,51,37,38,8,32,57,56.1,25,37,11,26,44,127,52,0,Matches
450,Chris Richards,us,"DF,MF",Crystal Palace,23,2000,23.3,46,28,21,22,3,20,30,66.7,10,32,12,20,27,73,109,0,Matches
451,Richarlison,br,FW,Tottenham,26,1997,16.6,16,11,4,8,4,2,10,20.0,8,32,6,26,8,24,23,0,Matches
452,Jaïro Riedewald,nl,"MF,FW",Crystal Palace,26,1996,2.6,9,3,2,4,3,3,6,50.0,3,0,0,0,2,11,2,0,Matches
453,Matt Ritchie,sct,"FW,MF",Newcastle Utd,33,1989,1.4,5,3,2,2,1,2,4,50.0,2,3,2,1,1,6,5,0,Matches
454,Connor Roberts,wls,DF,Burnley,27,1995,9.1,12,5,6,4,2,8,17,47.1,9,8,6,2,4,16,25,2,Matches
455,Andrew Robertson,sct,DF,Liverpool,29,1994,18.8,35,24,21,11,3,26,43,60.5,17,20,6,14,13,48,40,0,Matches
456,Antonee Robinson,us,DF,Fulham,25,1997,36.3,93,58,60,26,7,52,110,47.3,58,56,8,48,80,173,117,3,Matches
457,Jack Robinson,eng,DF,Sheffield Utd,29,1993,32.1,43,28,29,14,0,25,39,64.1,14,49,33,16,33,76,132,2,Matches
458,Rodri,es,MF,Manchester City,27,1996,32.6,70,43,25,33,12,29,60,48.3,31,32,8,24,26,96,41,4,Matches
459,Jay Rodriguez,eng,FW,Burnley,34,1989,9.1,14,9,7,4,3,7,13,53.8,6,11,1,10,1,15,8,0,Matches
460,Mads Roerslev,dk,DF,Brentford,24,1999,22.1,48,31,34,9,5,27,54,50.0,27,15,3,12,19,67,71,0,Matches
461,Morgan Rogers,eng,"MF,FW",Aston Villa,21,2002,7.1,8,1,3,2,3,2,11,18.2,9,11,0,11,3,11,11,0,Matches
462,Cristian Romero,ar,DF,Tottenham,25,1998,31.0,66,40,35,25,6,32,44,72.7,12,46,22,24,44,110,106,1,Matches
463,Joe Rothwell,eng,MF,Bournemouth,28,1995,4.3,7,2,4,2,1,2,8,25.0,6,4,2,2,3,10,2,0,Matches
464,Pelly Ruddock Mpanzu,cd,MF,Luton Town,30,1993,12.2,13,5,6,6,1,5,9,55.6,4,15,7,8,9,22,16,3,Matches
465,José Sá,pt,GK,Wolves,30,1993,33.7,0,0,0,0,0,0,1,0.0,1,3,0,3,0,0,21,5,Matches
466,Dominic Sadi,eng,FW,Bournemouth,19,2003,0.0,0,0,0,0,0,0,0,,0,0,0,0,0,0,0,0,Matches
467,Bukayo Saka,eng,FW,Arsenal,21,2001,32.4,66,35,22,24,20,26,59,44.1,33,43,2,41,15,81,24,1,Matches
468,Mohamed Salah,eg,FW,Liverpool,31,1992,28.2,17,11,1,8,8,6,21,28.6,15,19,1,18,2,19,1,0,Matches
469,William Saliba,fr,DF,Arsenal,22,2001,38.0,41,26,28,12,1,20,27,74.1,7,32,17,15,29,70,81,3,Matches
470,Albert Sambi Lokonga,be,MF,Luton Town,23,1999,14.5,29,18,14,12,3,17,24,70.8,7,23,13,10,11,40,14,0,Matches
471,Davinson Sánchez,co,DF,Tottenham,27,1996,0.9,0,0,0,0,0,0,0,,0,3,2,1,1,1,2,0,Matches
472,Robert Sánchez,es,GK,Chelsea,25,1997,15.9,0,0,0,0,0,0,0,,0,0,0,0,0,0,11,3,Matches
473,Jadon Sancho,eng,"FW,MF",Manchester Utd,23,2000,0.9,1,0,1,0,0,1,3,33.3,2,1,0,1,1,2,0,0,Matches
474,Ibrahim Sangaré,ci,MF,Nott'ham Forest,25,1997,11.5,42,23,25,13,4,12,29,41.4,17,24,7,17,16,58,21,0,Matches
475,Andrey Santos,br,MF,Nott'ham Forest,19,2004,0.1,0,0,0,0,0,0,0,,0,1,0,1,0,0,0,0,Matches
476,Pablo Sarabia,es,"MF,FW",Wolves,31,1992,19.4,20,13,8,8,4,12,36,33.3,24,17,1,16,10,30,9,0,Matches
477,Dane Scarlett,eng,FW,Tottenham,19,2004,0.2,1,1,0,0,1,0,1,0.0,1,0,0,0,0,1,0,0,Matches
478,Kevin Schade,de,"FW,MF",Brentford,21,2001,3.7,3,1,1,2,0,0,5,0.0,5,2,0,2,1,4,4,0,Matches
479,Fabian Schär,ch,DF,Newcastle Utd,31,1991,33.9,42,24,27,13,2,18,40,45.0,22,50,38,12,36,78,133,1,Matches
480,Jeffrey Schlupp,gh,"FW,MF",Crystal Palace,30,1992,15.0,38,24,14,16,8,9,18,50.0,9,13,2,11,8,46,24,0,Matches
481,Alex Scott,eng,MF,Bournemouth,19,2003,11.3,24,15,8,10,6,12,28,42.9,16,14,4,10,12,36,18,2,Matches
482,Matz Sels,be,GK,Nott'ham Forest,31,1992,16.0,0,0,0,0,0,0,0,,0,0,0,0,0,0,11,1,Matches
483,Nélson Semedo,pt,"DF,MF",Wolves,29,1993,34.3,79,48,52,19,8,38,64,59.4,26,44,8,36,36,115,85,1,Matches
484,Antoine Semenyo,gh,FW,Bournemouth,23,2000,23.4,24,17,7,9,8,9,27,33.3,18,39,2,37,6,30,21,0,Matches
485,Marcos Senesi,ar,DF,Bournemouth,26,1997,24.9,55,32,28,23,4,24,56,42.9,32,50,23,27,35,90,109,1,Matches
486,Luke Shaw,eng,DF,Manchester Utd,28,1995,10.7,11,8,7,3,1,9,15,60.0,6,18,11,7,6,17,39,0,Matches
487,James Shea,eng,GK,Luton Town,32,1991,0.2,0,0,0,0,0,0,0,,0,0,0,0,0,0,2,0,Matches
488,Bernardo Silva,pt,"MF,FW",Manchester City,28,1994,28.6,51,23,13,25,13,25,57,43.9,32,32,4,28,17,68,15,1,Matches
489,Fábio Silva,pt,FW,Wolves,21,2002,2.9,7,4,3,4,0,2,3,66.7,1,1,0,1,2,9,0,0,Matches
490,Thiago Silva,br,DF,Chelsea,38,1984,28.1,29,15,22,6,1,20,34,58.8,14,33,24,9,26,55,153,4,Matches
491,Luis Sinisterra,co,"FW,MF",Bournemouth,24,1999,7.8,23,12,9,10,4,9,16,56.3,7,18,0,18,8,31,4,0,Matches
492,Oliver Skipp,eng,"MF,DF",Tottenham,22,2000,7.9,18,12,9,6,3,11,18,61.1,7,12,1,11,3,21,9,0,Matches
493,Adam Smith,eng,DF,Bournemouth,32,1991,23.9,37,23,18,11,8,19,39,48.7,20,28,11,17,21,58,62,0,Matches
494,Emile Smith Rowe,eng,MF,Arsenal,23,2000,3.9,4,1,2,2,0,2,4,50.0,2,3,1,2,3,7,1,0,Matches
495,Cédric Soares,pt,DF,Arsenal,31,1991,0.7,0,0,0,0,0,0,0,,0,0,0,0,0,0,0,0,Matches
496,Dominic Solanke,eng,FW,Bournemouth,25,1997,36.9,23,11,3,13,7,10,29,34.5,19,24,5,19,7,30,43,0,Matches
497,Manor Solomon,il,FW,Tottenham,24,1999,2.2,3,3,1,1,1,1,2,50.0,1,4,0,4,3,6,2,0,Matches
498,Tomáš Souček,cz,MF,West Ham,28,1995,31.9,53,35,24,26,3,21,47,44.7,26,55,28,27,37,90,109,0,Matches
499,Vinicius Souza,br,MF,Sheffield Utd,24,1999,29.6,125,76,59,51,15,41,74,55.4,33,57,17,40,32,157,75,1,Matches
500,Jason Steele,eng,GK,Brighton,32,1990,17.0,0,0,0,0,0,0,3,0.0,3,0,0,0,0,0,8,1,Matches
501,Raheem Sterling,eng,"FW,MF",Chelsea,28,1994,22.0,21,10,7,8,6,12,26,46.2,14,13,0,13,13,34,9,1,Matches
502,John Stones,eng,"DF,MF",Manchester City,29,1994,11.8,2,1,1,0,1,0,3,0.0,3,11,7,4,10,12,21,0,Matches
503,Thomas Strakosha,al,GK,Brentford,28,1995,1.5,0,0,0,0,0,0,0,,0,0,0,0,0,0,0,0,Matches
504,Dominik Szoboszlai,hu,MF,Liverpool,22,2000,23.4,32,19,12,12,8,16,50,32.0,34,37,2,35,15,47,16,1,Matches
505,Matt Targett,eng,DF,Newcastle Utd,27,1995,0.9,2,0,1,1,0,1,1,100.0,0,1,0,1,0,2,2,0,Matches
506,James Tarkowski,eng,DF,Everton,30,1992,38.0,61,42,46,14,1,27,48,56.3,21,82,56,26,56,117,191,2,Matches
507,Jimi Tauriainen,eng,FW,Chelsea,19,2004,0.0,0,0,0,0,0,0,0,,0,0,0,0,0,0,0,0,Matches
508,Nuno Tavares,pt,DF,Nott'ham Forest,23,2000,5.1,11,7,9,1,1,8,9,88.9,1,6,0,6,1,12,21,0,Matches
509,Marcus Tavernier,eng,FW,Bournemouth,24,1999,23.5,53,34,25,22,6,26,48,54.2,22,31,3,28,5,58,23,0,Matches
510,Charlie Taylor,eng,DF,Burnley,29,1993,25.9,35,20,19,14,2,17,35,48.6,18,27,11,16,19,54,78,0,Matches
511,Kenny Tete,nl,DF,Fulham,27,1995,9.6,27,17,19,6,2,11,19,57.9,8,10,3,7,16,43,35,0,Matches
512,Luke Thomas,eng,DF,Sheffield Utd,22,2001,10.2,20,9,13,6,1,8,14,57.1,6,23,5,18,10,30,27,0,Matches
513,Youri Tielemans,be,"MF,FW",Aston Villa,26,1997,18.0,41,20,17,18,6,16,40,40.0,24,23,3,20,15,56,9,0,Matches
514,Jurriën Timber,nl,DF,Arsenal,22,2001,0.8,2,2,1,1,0,0,0,,0,1,0,1,0,2,1,0,Matches
515,Harry Toffolo,eng,DF,Nott'ham Forest,27,1995,16.2,26,14,20,6,0,15,24,62.5,9,34,13,21,14,40,49,0,Matches
516,Takehiro Tomiyasu,jp,DF,Arsenal,24,1998,12.8,20,9,15,4,1,11,18,61.1,7,10,4,6,18,38,33,0,Matches
517,James Tomkins,eng,DF,Crystal Palace,34,1989,0.1,0,0,0,0,0,0,0,,0,0,0,0,1,1,0,0,Matches
518,Sandro Tonali,it,MF,Newcastle Utd,23,2000,4.9,7,7,4,2,1,3,9,33.3,6,3,0,3,2,9,4,0,Matches
519,Ivan Toney,eng,FW,Brentford,27,1996,16.1,15,5,2,7,6,6,14,42.9,8,5,1,4,10,25,18,0,Matches
520,Pau Torres,es,DF,Aston Villa,26,1997,27.4,29,18,17,11,1,14,30,46.7,16,28,12,16,14,43,75,0,Matches
521,Andros Townsend,eng,"MF,FW",Luton Town,32,1991,13.4,21,13,11,2,8,13,27,48.1,14,12,0,12,5,26,10,0,Matches
522,James Trafford,eng,GK,Burnley,20,2002,28.0,2,1,2,0,0,2,2,100.0,0,0,0,0,1,3,18,1,Matches
523,Adama Traoré,es,"FW,MF",Fulham,27,1996,4.2,4,3,1,2,1,3,6,50.0,3,2,0,2,1,5,2,0,Matches
524,Bénie Traoré,ci,"FW,MF",Sheffield Utd,20,2002,4.3,4,2,1,2,1,0,4,0.0,4,4,1,3,1,5,1,0,Matches
525,Bertrand Traoré,bf,"DF,FW",Aston Villa,27,1995,0.1,1,1,1,0,0,0,0,,0,0,0,0,0,1,1,0,Matches
526,Boubacar Traoré,ml,MF,Wolves,21,2001,9.1,35,23,16,17,2,9,21,42.9,12,12,2,10,5,40,7,0,Matches
527,Mark Travers,ie,GK,Bournemouth,24,1999,4.0,0,0,0,0,0,0,0,,0,0,0,0,0,0,2,0,Matches
528,Mike Trésor,be,"FW,MF",Burnley,24,1999,4.7,10,6,9,1,0,8,18,44.4,10,5,0,5,1,11,1,0,Matches
529,Kieran Trippier,eng,DF,Newcastle Utd,32,1990,24.8,57,27,30,16,11,37,77,48.1,40,41,8,33,24,81,57,3,Matches
530,Leandro Trossard,be,"FW,MF",Arsenal,28,1994,18.3,27,16,8,9,10,9,25,36.0,16,27,1,26,8,35,6,0,Matches
531,Auston Trusty,us,DF,Sheffield Utd,24,1998,28.6,47,30,31,13,3,21,43,48.8,22,41,22,19,35,82,153,3,Matches
532,Kostas Tsimikas,gr,DF,Liverpool,27,1996,7.5,19,13,9,6,4,9,15,60.0,6,9,1,8,6,25,10,0,Matches
533,Matt Turner,us,GK,Nott'ham Forest,29,1994,17.0,0,0,0,0,0,0,0,,0,0,0,0,0,0,8,4,Matches
534,Destiny Udogie,it,DF,Tottenham,20,2002,26.6,68,33,41,16,11,27,49,55.1,22,27,8,19,37,105,80,5,Matches
535,Lesley Ugochukwu,fr,MF,Chelsea,19,2004,3.3,14,10,4,8,2,4,10,40.0,6,6,2,4,1,15,5,0,Matches
536,Enes Ünal,tr,"FW,MF",Bournemouth,26,1997,3.6,6,4,2,3,1,2,5,40.0,3,4,2,2,1,7,6,0,Matches
537,Virgil van Dijk,nl,DF,Liverpool,32,1991,35.3,40,23,24,13,3,12,14,85.7,2,47,34,13,39,79,144,0,Matches
538,Raphaël Varane,fr,DF,Manchester Utd,30,1993,15.3,18,11,10,7,1,10,14,71.4,4,23,18,5,15,33,88,0,Matches
539,Alejo Véliz,ar,FW,Tottenham,19,2003,0.6,1,0,1,0,0,0,0,,0,0,0,0,0,1,0,0,Matches
540,Joël Veltman,nl,DF,Brighton,31,1992,17.6,54,41,32,17,5,39,58,67.2,19,17,7,10,18,72,57,1,Matches
541,Micky van de Ven,nl,DF,Tottenham,22,2001,26.0,49,35,34,12,3,24,33,72.7,9,25,15,10,18,67,78,1,Matches
542,Bart Verbruggen,nl,GK,Brighton,20,2002,21.0,1,1,1,0,0,1,2,50.0,1,0,0,0,0,1,11,3,Matches
543,Guglielmo Vicario,it,GK,Tottenham,26,1996,38.0,0,0,0,0,0,0,1,0.0,1,0,0,0,1,1,31,2,Matches
544,Fabio Vieira,pt,"MF,FW",Arsenal,23,2000,3.3,3,2,2,0,1,3,3,100.0,0,0,0,0,2,5,2,0,Matches
545,Carlos Vinícius,br,FW,Fulham,28,1995,3.5,3,2,0,1,2,0,4,0.0,4,4,0,4,0,3,1,0,Matches
546,Vitinho,br,"DF,MF",Burnley,24,1999,25.7,64,34,36,22,6,43,86,50.0,43,44,6,38,12,76,47,4,Matches
547,Odisseas Vlachodimos,gr,GK,Nott'ham Forest,29,1994,5.0,0,0,0,0,0,0,1,0.0,1,0,0,0,0,0,1,0,Matches
548,Kyle Walker,eng,DF,Manchester City,33,1990,30.7,38,24,19,17,2,19,39,48.7,20,19,6,13,27,65,40,1,Matches
549,Aaron Wan-Bissaka,eng,DF,Manchester Utd,25,1997,19.8,42,25,18,20,4,19,26,73.1,7,29,15,14,41,83,68,1,Matches
550,Joel Ward,eng,DF,Crystal Palace,33,1989,22.0,45,28,26,18,1,30,47,63.8,17,17,10,7,14,59,94,1,Matches
551,James Ward-Prowse,eng,MF,West Ham,28,1994,33.3,45,29,14,23,8,18,44,40.9,26,31,9,22,38,83,49,0,Matches
552,Lewis Warrington,eng,FW,Everton,20,2002,0.0,0,0,0,0,0,0,0,,0,0,0,0,0,0,0,0,Matches
553,Deivid Washington,br,"DF,FW",Chelsea,18,2005,0.1,1,1,1,0,0,0,1,0.0,1,0,0,0,0,1,0,0,Matches
554,Ollie Watkins,eng,FW,Aston Villa,27,1995,35.7,12,7,0,5,7,5,11,45.5,6,26,4,22,4,16,20,0,Matches
555,Adam Webster,eng,DF,Brighton,28,1995,12.7,14,12,8,5,1,6,18,33.3,12,16,12,4,16,30,43,1,Matches
556,Danny Welbeck,eng,"FW,MF",Brighton,32,1990,18.8,35,17,9,17,9,10,17,58.8,7,12,0,12,9,44,17,1,Matches
557,Timo Werner,de,FW,Tottenham,27,1996,9.0,7,4,3,4,0,5,18,27.8,13,12,0,12,3,10,2,0,Matches
558,Adam Wharton,eng,MF,Crystal Palace,19,2004,14.4,48,32,18,22,8,23,46,50.0,23,17,3,14,20,68,24,1,Matches
559,Ethan Wheatley,eng,FW,Manchester Utd,17,2006,0.2,1,1,0,1,0,1,1,100.0,0,2,0,2,2,3,0,0,Matches
560,Ben White,eng,DF,Arsenal,25,1997,33.2,48,28,20,22,6,26,58,44.8,32,48,22,26,32,80,77,1,Matches
561,Joe White,eng,MF,Newcastle Utd,20,2002,0.1,1,1,1,0,0,0,0,,0,0,0,0,0,1,0,0,Matches
562,Neco Williams,wls,DF,Nott'ham Forest,22,2001,18.2,69,40,42,18,9,35,56,62.5,21,44,13,31,22,91,53,0,Matches
563,Willian,br,FW,Fulham,34,1988,22.8,18,11,6,7,5,3,21,14.3,18,13,0,13,9,27,12,1,Matches
564,Joe Willock,eng,MF,Newcastle Utd,23,1999,4.7,13,7,7,6,0,4,11,36.4,7,7,0,7,1,14,1,0,Matches
565,Callum Wilson,eng,FW,Newcastle Utd,31,1992,11.0,5,3,0,2,3,0,4,0.0,4,6,0,6,2,7,4,0,Matches
566,Harry Wilson,wls,FW,Fulham,26,1997,18.0,21,14,9,8,4,11,28,39.3,17,27,3,24,10,31,12,0,Matches
567,Yoane Wissa,cd,FW,Brentford,26,1996,27.7,28,16,13,10,5,5,20,25.0,15,24,3,21,9,37,15,0,Matches
568,Chris Wood,nz,FW,Nott'ham Forest,31,1991,20.1,7,4,1,4,2,3,9,33.3,6,11,3,8,1,8,26,0,Matches
569,Cauley Woodrow,eng,"FW,MF",Luton Town,28,1994,4.7,16,10,8,4,4,9,16,56.3,7,7,1,6,1,17,14,0,Matches
570,Joe Worrall,eng,DF,Nott'ham Forest,26,1997,4.9,7,5,6,1,0,3,6,50.0,3,5,4,1,3,10,32,1,Matches
571,Yehor Yarmoliuk,ua,MF,Brentford,19,2004,7.6,17,11,6,8,3,7,17,41.2,10,17,4,13,6,23,5,0,Matches
572,Ryan Yates,eng,MF,Nott'ham Forest,25,1997,22.1,66,39,39,21,6,19,34,55.9,15,42,15,27,21,87,44,1,Matches
573,Ashley Young,eng,"DF,MF",Everton,38,1985,25.3,53,38,28,19,6,30,54,55.6,24,24,6,18,22,75,50,3,Matches
574,Illia Zabarnyi,ua,DF,Bournemouth,20,2002,37.0,59,32,29,29,1,23,50,46.0,27,53,34,19,33,92,143,4,Matches
575,Nicolò Zaniolo,it,"FW,MF",Aston Villa,24,1999,9.3,19,9,10,7,2,9,17,52.9,8,13,0,13,1,20,11,0,Matches
576,Anass Zaroury,ma,"FW,MF",Burnley,22,2000,1.7,1,0,1,0,0,0,4,0.0,4,2,0,2,0,1,1,1,Matches
577,Oleksandr Zinchenko,ua,DF,Arsenal,26,1996,19.1,50,30,19,24,7,35,52,67.3,17,18,3,15,20,70,26,2,Matches
578,Kurt Zouma,fr,DF,West Ham,28,1994,31.5,23,17,14,9,0,10,16,62.5,6,38,28,10,29,52,160,0,Matches
579,Martin Ødegaard,no,MF,Arsenal,24,1998,34.3,49,17,18,21,10,17,58,29.3,41,23,1,22,15,64,5,0,Matches
